xx++++++++++++++
+xx++++++xxxxxx+
+xxx+++++xxxxxx+
+++xx++++++xxxx+
++++xxxxxxxxxxx+
+++++++++++++xx+
+++++++++++++xx+
+xxxxxxxxxxxxxx+
+xxx++++++++++++
+++xxx++xxxxxxx+
++++xx++x++++xx+
+ +++    ++++  +
+     +++      +
+++++     ++++++
+++++++++     O+
++++++++++++++++
